"filename", "language", "XML", "CSS", "Java", "comment", "blank", "total"
"c:\Users\noval\Documents\GitHub\gradeappv3\src\main\java\com\gradeapp\controller\AssessmentController.java", "Java", 0, 0, 38, 55, 12, 105
"c:\Users\noval\Documents\GitHub\gradeappv3\src\main\java\com\gradeapp\controller\AssessmentCreationController.java", "Java", 0, 0, 124, 0, 22, 146
"c:\Users\noval\Documents\GitHub\gradeappv3\src\main\java\com\gradeapp\controller\ClassController.java", "Java", 0, 0, 2, 0, 0, 2
"c:\Users\noval\Documents\GitHub\gradeappv3\src\main\java\com\gradeapp\controller\CourseDetailsController.java", "Java", 0, 0, 32, 0, 6, 38
"c:\Users\noval\Documents\GitHub\gradeappv3\src\main\java\com\gradeapp\controller\CourseEditController.java", "Java", 0, 0, 22, 0, 6, 28
"c:\Users\noval\Documents\GitHub\gradeappv3\src\main\java\com\gradeapp\controller\CoursesController.java", "Java", 0, 0, 9, 0, -1, 8
"c:\Users\noval\Documents\GitHub\gradeappv3\src\main\java\com\gradeapp\database\Database.java", "Java", 0, 0, 98, 2, 11, 111
"c:\Users\noval\Documents\GitHub\gradeappv3\src\main\java\com\gradeapp\model\Course.java", "Java", 0, 0, 7, 0, 1, 8
"c:\Users\noval\Documents\GitHub\gradeappv3\src\main\java\com\gradeapp\model\Outcome.java", "Java", 0, 0, 5, 0, 1, 6
"c:\Users\noval\Documents\GitHub\gradeappv3\src\main\resources\org\example\demo3\assessment-creation.fxml", "XML", 31, 0, 0, 0, 10, 41
"c:\Users\noval\Documents\GitHub\gradeappv3\src\main\resources\org\example\demo3\assessment-view.fxml", "XML", 6, 0, 0, 0, 0, 6
"c:\Users\noval\Documents\GitHub\gradeappv3\src\main\resources\org\example\demo3\classes-view.fxml", "XML", 8, 0, 0, 0, 0, 8
"c:\Users\noval\Documents\GitHub\gradeappv3\src\main\resources\org\example\demo3\course-creation.fxml", "XML", 18, 0, 0, 0, 1, 19
"c:\Users\noval\Documents\GitHub\gradeappv3\src\main\resources\org\example\demo3\course-details.fxml", "XML", 2, 0, 0, 0, 1, 3
"c:\Users\noval\Documents\GitHub\gradeappv3\src\main\resources\org\example\demo3\courses-view.fxml", "XML", 2, 0, 0, -2, -1, -1
"c:\Users\noval\Documents\GitHub\gradeappv3\src\main\resources\org\example\demo3\icons\assessments.svg", "XML", 1, 0, 0, 0, 0, 1
"c:\Users\noval\Documents\GitHub\gradeappv3\src\main\resources\org\example\demo3\students-view.fxml", "XML", 16, 0, 0, 0, -1, 15
"c:\Users\noval\Documents\GitHub\gradeappv3\src\main\resources\org\example\demo3\styles.css", "CSS", 0, 26, 0, 1, 1, 28
"Total", "-", 84, 26, 337, 56, 69, 572